0100010001000100
1001000101000100
1000010001000100
0001001001000100
0001000001000100
1000001001000100
0100010001000100
1000100001000100
0100010001000100
1001000101000100
1000010001000100
0001001001000100
0001000001000100
1000001001000100
0100010001000100
1000100001000100