22222222
22222212
20222222
22222222
22222222
22229222
20222222
22222222