22222222
22222212
20222222
22222422
23222222
22222222
20222222
22222222